CRN,instructor_id,catalog_desc_id,course_offering_id,cap,act,rem
58124,10,275.0,12655,25,28,-3
58125,10,275.0,12656,25,24,1
58101,9,313.0,12657,22,23,-1
58102,9,313.0,12658,20,23,-3
58202,9,313.0,12659,22,22,0
58103,772,365.0,12660,22,23,-1
58104,14,365.0,12661,22,24,-2
58203,14,365.0,12662,22,20,2
58419,18,92.0,12664,15,14,1
58219,23,28.0,12665,20,20,0
58081,34,163.0,12667,20,20,0
58001,40,75.0,12670,20,16,4
58156,671,76.0,12672,0,20,-20
58186,671,76.0,12673,0,22,-22
58155,672,174.0,12675,20,18,2
58341,698,175.0,12677,20,17,3
58187,61,213.0,12678,0,22,-22
58188,61,213.0,12679,0,20,-20
58342,49,214.0,12680,25,23,2
58085,52,252.0,12681,16,14,2
58086,52,253.0,12682,16,14,2
58110,70,3.0,12687,20,13,7
58123,105,1670.0,12704,20,19,1
58004,111,1909.0,12705,20,17,3
58018,814,1483.0,12712,12,12,0
58019,678,1485.0,12713,20,12,8
58021,1001,1689.0,12715,15,13,2
58055,815,1790.0,12716,19,20,-1
58381,117,1869.0,12717,20,11,9
58007,128,1369.0,12720,0,14,-14
58368,127,1369.0,12721,20,12,8
58008,132,1477.0,12723,20,18,2
58022,679,1566.0,12725,27,27,0
58023,143,1853.0,12727,30,29,1
58024,712,1854.0,12728,22,22,0
58025,140,1854.0,12729,23,23,0
58382,977,1914.0,12730,22,20,2
58026,976,1915.0,12731,26,27,-1
58254,816,1383.0,12736,25,25,0
58388,155,,12737,20,18,2
58390,816,1719.0,12739,20,13,7
58348,19,1505.0,12747,20,14,6
58350,180,1984.0,12748,20,15,5
58351,216,2026.0,12751,20,17,3
58163,231,1126.0,12757,15,11,4
58106,128,1730.0,12762,25,12,13
58107,239,1820.0,12763,25,13,12
58113,273,857.0,12767,20,14,6
58192,792,186.0,12780,0,15,-15
58200,298,1324.0,12784,25,15,10
58108,299,1325.0,12785,18,18,0
58164,304,1637.0,12786,25,19,6
58204,313,739.0,12788,25,19,6
58333,313,802.0,12789,20,21,-1
58109,311,1087.0,12792,25,11,14
58402,869,1116.0,12794,25,23,2
58029,316,1117.0,12795,20,19,1
58251,319,1185.0,12798,20,18,2
58032,321,1263.0,12799,20,18,2
58033,315,1264.0,12800,20,13,7
58013,342,867.0,12814,25,14,11
58352,345,1082.0,12816,20,13,7
58450,345,1082.0,12817,20,12,8
58420,159,,12818,12,12,0
58236,368,1187.0,12827,20,20,0
58060,375,770.0,12830,60,57,3
58061,419,835.0,12831,60,57,3
58063,374,838.0,12833,60,59,1
58064,385,906.0,12834,20,19,1
58179,381,906.0,12835,20,20,0
58180,383,906.0,12836,20,20,0
58065,376,907.0,12837,60,59,1
58070,380,1045.0,12846,60,58,2
58071,820,1046.0,12847,15,13,2
58182,383,1046.0,12848,15,15,0
58183,374,1046.0,12849,15,15,0
58454,377,1046.0,12850,15,15,0
58072,389,1113.0,12851,18,16,2
58208,876,1181.0,12854,51,48,3
58074,399,1351.0,12863,51,51,0
58080,374,1442.0,12871,51,48,3
58190,43,1443.0,12872,51,48,3
58377,425,1760.0,12874,40,22,18
58126,387,1761.0,12875,38,36,2
58127,399,1844.0,12876,42,38,4
58128,372,1845.0,12877,20,17,3
58216,387,1904.0,12878,15,13,2
58129,634,1907.0,12879,15,14,1
58130,389,1956.0,12880,25,23,2
58132,51,2066.0,12883,15,15,0
58133,426,2067.0,12884,30,16,14
58134,420,2067.0,12885,30,14,16
58135,420,604.0,12888,15,15,0
58136,420,605.0,12889,15,15,0
58137,688,608.0,12890,15,15,0
58138,420,671.0,12891,15,14,1
58139,429,735.0,12892,15,15,0
58114,430,463.0,12895,20,16,4
58397,912,529.0,12896,20,17,3
58097,459,535.0,12900,20,19,1
58239,457,593.0,12901,25,24,1
58240,457,594.0,12902,25,21,4
58243,638,525.0,12908,20,13,7
58017,478,526.0,12910,15,14,1
58040,485,1346.0,12913,15,11,4
58042,157,1437.0,12915,20,17,3
58257,151,1440.0,12917,11,11,0
58447,881,412.0,12920,15,12,3
58398,430,306.0,12924,20,15,5
58400,691,449.0,12925,20,19,1
58399,928,451.0,12926,20,21,-1
58391,1010,516.0,12930,20,12,8
58189,963,559.0,12931,25,13,12
58099,492,559.0,12932,20,18,2
58444,492,559.0,12933,20,19,1
58100,645,943.0,12935,20,19,1
58150,645,943.0,12936,20,17,3
58338,520,586.0,12941,12,14,-2
58046,829,414.0,12943,20,11,9
58047,151,416.0,12944,20,13,7
58457,656,416.0,12945,20,16,4
58269,658,611.0,12948,20,16,4
58334,698,,12955,30,24,6
58162,12,238.0,12961,22,16,6
74177,1,2333.0,12963,0,28,-28
74194,4,2333.0,12964,0,32,-32
74195,4,2333.0,12965,0,32,-32
74196,930,2333.0,12966,0,29,-29
74197,930,2333.0,12967,0,29,-29
74349,2,2333.0,12968,0,32,-32
74359,6,2333.0,12969,31,29,2
74543,6,2333.0,12970,31,30,1
74749,6,2333.0,12971,31,30,1
74750,11,2333.0,12972,31,31,0
74929,11,2333.0,12973,31,33,-2
74930,772,2333.0,12974,31,33,-2
74931,772,2333.0,12975,31,29,2
75084,1011,2333.0,12976,31,32,-1
75689,4,2333.0,12977,33,31,2
75690,4,2333.0,12978,31,30,1
74152,8,2355.0,12979,24,21,3
74932,8,2355.0,12980,24,19,5
74039,9,2356.0,12981,22,20,2
74040,9,2356.0,12982,22,24,-2
74852,5,2356.0,12983,22,24,-2
75468,5,2356.0,12984,22,24,-2
74256,6,2357.0,12985,24,17,7
74934,14,2378.0,12986,20,18,2
75085,14,2378.0,12987,20,18,2
74156,8,2379.0,12988,26,20,6
75264,11,2379.0,12989,28,28,0
74146,1012,2381.0,12990,22,15,7
74572,567,2381.0,12991,29,29,0
75086,930,2381.0,12992,27,28,-1
74041,1013,2407.0,12993,30,29,1
74351,1013,2407.0,12994,29,29,0
75951,9,2407.0,12995,22,20,2
75691,2,2410.0,12996,15,12,3
74648,1,2494.0,13000,24,23,1
74649,15,2584.0,13001,15,18,-3
74650,15,2584.0,13002,15,16,-1
74651,15,2584.0,13003,15,17,-2
75265,931,2584.0,13004,16,17,-1
74652,16,2626.0,13005,15,17,-2
74653,16,2626.0,13006,16,16,0
75266,16,2626.0,13007,15,17,-2
74357,21,2246.0,13014,28,28,0
74358,21,2246.0,13015,28,29,-1
74240,775,2248.0,13017,28,28,0
75094,775,2248.0,13018,28,28,0
74542,22,2249.0,13019,0,19,-19
75649,23,2249.0,13020,28,14,14
75029,23,2249.0,13021,20,20,0
74954,24,2250.0,13022,25,25,0
75650,24,2250.0,13023,25,24,1
75651,21,2254.0,13024,24,17,7
74953,568,2257.0,13025,28,25,3
74264,25,2303.0,13026,30,26,4
74187,25,2318.0,13027,29,29,0
74229,26,2335.0,13028,30,29,1
74797,27,2336.0,13029,30,29,1
75863,696,2338.0,13030,30,30,0
74104,440,2339.0,13031,30,29,1
74001,29,2358.0,13032,27,24,3
75136,696,2358.0,13033,30,29,1
74248,31,2383.0,13034,30,29,1
74975,30,2383.0,13035,30,30,0
74976,569,2383.0,13036,30,30,0
75039,569,2383.0,13037,30,30,0
75864,30,2383.0,13038,30,29,1
75865,1014,2383.0,13039,25,25,0
74003,34,2383.0,13040,20,18,2
74054,34,2383.0,13041,20,17,3
74253,32,2383.0,13042,20,20,0
76018,32,2383.0,13043,20,19,1
74135,37,2286.0,13045,25,20,5
74136,37,2286.0,13046,25,19,6
74338,36,2286.0,13047,25,23,2
74418,37,2286.0,13048,25,14,11
74987,38,2286.0,13049,0,21,-21
76027,38,2286.0,13050,0,15,-15
75481,40,2295.0,13051,25,25,0
74822,42,2296.0,13052,25,26,-1
75377,42,2297.0,13053,25,25,0
75754,36,2307.0,13054,25,25,0
75357,776,2322.0,13055,25,26,-1
75755,894,2341.0,13056,25,25,0
75756,40,2344.0,13057,25,24,1
76028,40,2344.0,13058,25,22,3
75757,37,2363.0,13059,25,19,6
74666,833,2368.0,13066,24,22,2
75212,833,2368.0,13067,24,24,0
74174,45,2393.0,13068,24,24,0
74245,45,2393.0,13069,24,25,-1
75353,54,2393.0,13070,24,20,4
75318,47,2395.0,13071,24,24,0
75025,61,2433.0,13072,12,13,-1
74798,50,2434.0,13073,24,24,0
74799,50,2434.0,13074,24,24,0
75634,1015,2434.0,13075,24,21,3
75635,574,,13076,24,23,1
74624,51,2472.0,13077,13,14,-1
74754,51,2472.0,13078,0,60,-60
74838,52,2472.0,13079,18,20,-2
74839,52,2472.0,13080,0,56,-56
75964,51,2472.0,13081,0,56,-56
74456,836,2473.0,13082,20,19,1
74460,51,2473.0,13083,20,20,0
74483,52,2473.0,13084,20,19,1
74484,52,2473.0,13085,21,19,2
74485,836,2473.0,13086,20,19,1
74728,834,2473.0,13087,20,14,6
74850,51,2473.0,13088,20,19,1
75196,52,2473.0,13089,20,20,0
75208,834,2473.0,13090,20,17,3
75478,836,2473.0,13091,20,20,0
75965,836,2473.0,13092,20,20,0
74227,698,2519.0,13093,40,40,0
75354,698,2519.0,13094,40,38,2
74488,698,2520.0,13095,16,14,2
74489,698,2520.0,13096,16,16,0
74490,835,2520.0,13097,16,16,0
75112,835,2520.0,13098,16,16,0
75355,698,2520.0,13099,16,16,0
74167,60,2564.0,13100,34,20,14
74352,60,2564.0,13101,0,41,-41
74840,60,2564.0,13102,30,20,10
74841,60,2564.0,13103,0,33,-33
74491,152,2565.0,13104,16,14,2
74492,56,2565.0,13105,16,13,3
74493,58,2565.0,13106,16,12,4
74494,56,2565.0,13107,16,12,4
74496,57,2565.0,13109,16,16,0
74497,56,2565.0,13110,16,13,3
74498,57,2565.0,13111,16,12,4
75962,64,2565.0,13112,16,12,4
74502,43,2566.0,13115,12,11,1
74505,43,2566.0,13117,12,11,1
74202,61,2608.0,13125,64,55,9
74513,61,2609.0,13126,16,16,0
74514,67,2609.0,13127,16,16,0
74842,62,2609.0,13129,16,13,3
75636,1016,2723.0,13136,18,18,0
74969,572,2973.0,13142,12,13,-1
74327,47,3099.0,13143,14,13,1
74516,47,3100.0,13144,14,13,1
75638,67,3170.0,13145,14,13,1
75639,67,3171.0,13146,14,13,1
75640,68,3245.0,13147,13,13,0
75641,68,3246.0,13148,13,13,0
75451,494,2229.0,13158,20,20,0
74178,70,2223.0,13159,25,24,1
74235,70,2223.0,13160,25,24,1
74355,69,2223.0,13161,26,26,0
74630,71,2223.0,13162,25,25,0
74834,71,2223.0,13163,25,23,2
75041,702,2223.0,13164,27,27,0
75105,702,2223.0,13165,25,27,-2
75627,70,2223.0,13166,25,23,2
74179,70,2227.0,13167,25,15,10
75941,1017,,13176,20,32,-12
75942,275,,13177,20,27,-7
75107,86,3999.0,13178,24,24,0
74237,78,4003.0,13180,30,29,1
75316,78,4003.0,13181,30,22,8
75647,838,4003.0,13182,30,29,1
74440,76,4077.0,13183,16,16,0
74442,78,4077.0,13185,16,16,0
74805,76,4077.0,13186,16,14,2
75211,78,4077.0,13187,16,13,3
75648,76,4077.0,13188,16,15,1
74439,80,4078.0,13189,24,23,1
74347,81,4079.0,13190,20,20,0
75317,86,4080.0,13191,24,25,-1
74449,84,4139.0,13192,39,38,1
74450,90,4139.0,13193,39,32,7
74451,84,4139.0,13194,39,32,7
74535,83,4139.0,13195,39,33,6
75201,90,4139.0,13196,39,39,0
74429,83,4140.0,13197,16,15,1
74430,1018,4140.0,13198,16,15,1
74431,93,4140.0,13199,16,16,0
74432,88,4140.0,13200,16,15,1
74433,84,4140.0,13201,16,12,4
74434,88,4140.0,13202,16,14,2
74435,1019,4140.0,13203,16,14,2
74436,839,4140.0,13204,16,12,4
74437,674,4140.0,13205,16,13,3
74438,675,4140.0,13206,16,14,2
75215,675,4140.0,13207,16,14,2
75216,838,4140.0,13208,16,15,1
74048,80,4191.0,13210,25,26,-1
74049,76,4191.0,13211,25,25,0
74354,65,4191.0,13212,25,23,2
74443,91,4192.0,13213,16,15,1
74444,91,4192.0,13214,16,14,2
74445,92,4192.0,13215,16,14,2
74446,80,4192.0,13216,16,15,1
74447,92,4192.0,13217,16,12,4
74050,85,4237.0,13219,20,18,2
74806,65,4270.0,13222,12,17,-5
74964,572,4297.0,13224,12,12,0
75108,84,4301.0,13226,20,14,6
74278,94,3718.0,13233,18,11,7
74803,96,3824.0,13235,25,25,0
74804,1020,3824.0,13236,25,23,2
74111,1021,3784.0,13238,27,18,9
74122,1021,3784.0,13239,27,20,7
74538,1021,3784.0,13240,27,25,2
74112,100,3890.0,13241,16,15,1
74153,101,3890.0,13242,16,16,0
74405,100,3890.0,13243,16,14,2
74406,100,3890.0,13244,16,16,0
75091,314,3891.0,13245,27,26,1
74266,935,3892.0,13246,27,19,8
74858,97,3892.0,13247,0,25,-25
75251,935,3892.0,13248,27,26,1
74188,98,3988.0,13249,26,26,0
74353,98,3988.0,13250,26,26,0
74155,110,3991.0,13251,35,37,-2
74807,97,4070.0,13252,27,27,0
75745,111,4129.0,13253,27,26,1
75746,109,4131.0,13254,22,22,0
75747,109,4131.0,13255,23,24,-1
74407,110,4180.0,13256,25,20,5
74113,109,4181.0,13257,15,14,1
74114,109,4181.0,13258,15,16,-1
74139,111,4181.0,13259,15,13,2
74537,111,4181.0,13260,15,13,2
75093,98,4257.0,13261,20,22,-2
75748,935,4260.0,13262,17,14,3
75749,97,4262.0,13263,17,17,0
74808,111,4319.0,13264,17,16,1
75750,110,4322.0,13265,25,24,1
75229,98,4344.0,13266,0,22,-22
75256,1022,4345.0,13267,15,16,-1
75751,111,4362.0,13268,15,12,3
75982,1022,,13273,15,14,1
74939,162,3798.0,13282,18,16,2
75038,888,3587.0,13283,18,13,5
75712,706,3587.0,13284,18,12,6
75713,972,3687.0,13285,15,12,3
75455,972,3688.0,13286,20,18,2
75948,706,3688.0,13287,15,13,2
75461,972,3689.0,13288,24,17,7
75957,706,3689.0,13289,20,12,8
75463,511,3792.0,13290,24,23,1
75714,1023,3899.0,13292,20,12,8
74258,125,3701.0,13294,20,15,5
75434,125,3911.0,13300,20,16,4
74676,122,3912.0,13301,20,18,2
74677,118,3913.0,13302,20,18,2
74678,115,4086.0,13304,0,12,-12
74115,1024,3589.0,13315,26,22,4
74116,133,3589.0,13316,26,25,1
74117,128,3589.0,13317,0,26,-26
74118,586,3589.0,13318,26,23,3
74119,127,3589.0,13319,26,27,-1
74120,133,3589.0,13320,26,26,0
74121,133,3589.0,13321,26,23,3
74309,133,3589.0,13322,26,26,0
74310,132,3589.0,13323,26,25,1
74311,130,3589.0,13324,0,26,-26
74312,709,3589.0,13325,0,26,-26
74546,132,3589.0,13326,26,22,4
74625,709,3589.0,13327,0,26,-26
74626,130,3589.0,13328,0,25,-25
74627,75,3589.0,13329,26,26,0
74752,1024,3589.0,13330,26,24,2
74855,134,3589.0,13331,26,28,-2
74860,134,3589.0,13332,26,27,-1
74861,710,3589.0,13333,0,25,-25
74862,710,3589.0,13334,0,23,-23
74863,710,3589.0,13335,0,23,-23
75973,132,3589.0,13336,26,18,8
75996,1024,3589.0,13337,26,20,6
75452,132,3589.0,13338,20,11,9
75836,136,3699.0,13339,25,21,4
74004,131,3904.0,13340,25,23,2
75146,131,3904.0,13341,25,21,4
74005,128,3908.0,13343,25,23,2
75147,709,3908.0,13344,25,25,0
75148,127,4008.0,13345,25,24,1
75450,131,4081.0,13346,25,12,13
75837,1024,,13347,25,13,12
75006,130,4085.0,13348,25,22,3
74344,976,3586.0,13352,27,27,0
74006,679,3681.0,13353,25,24,1
75902,589,3681.0,13354,24,21,3
74201,145,3682.0,13355,21,21,0
74685,977,3685.0,13356,0,14,-14
74760,977,3685.0,13357,0,13,-13
75048,977,3685.0,13358,0,11,-11
74686,936,3787.0,13359,20,16,4
74687,143,3789.0,13360,20,11,9
75221,143,3789.0,13361,20,13,7
75175,936,3893.0,13362,23,23,0
75908,151,3894.0,13363,20,12,8
74849,977,3895.0,13364,29,28,1
75436,145,3896.0,13365,20,16,4
74693,682,4187.0,13374,27,27,0
74129,155,3507.0,13382,21,19,2
74707,1027,3603.0,13383,20,14,6
75966,816,3603.0,13384,0,14,-14
74708,783,3719.0,13386,20,14,6
75446,922,3940.0,13387,20,11,9
75974,1028,3940.0,13388,0,14,-14
74131,166,3409.0,13401,17,17,0
74181,166,3409.0,13402,17,17,0
75722,330,3409.0,13403,17,14,3
74529,330,3492.0,13404,13,15,-2
74530,161,3492.0,13405,12,13,-1
74756,112,3492.0,13406,13,14,-1
74325,162,3676.0,13411,15,13,2
74531,160,3677.0,13412,15,13,2
74226,707,3349.0,13413,0,19,-19
74608,846,3349.0,13414,0,20,-20
74941,354,3349.0,13415,0,20,-20
75114,112,3349.0,13416,0,21,-21
75203,1030,3523.0,13417,20,18,2
74362,848,3619.0,13418,60,62,-2
74007,722,3508.0,13419,19,19,0
74008,176,3508.0,13420,19,19,0
74009,209,3508.0,13421,19,19,0
74010,173,3508.0,13422,19,19,0
74011,188,3508.0,13423,19,19,0
74012,723,3508.0,13424,19,19,0
74013,1031,3508.0,13425,19,19,0
74014,198,3508.0,13426,19,19,0
74015,175,3508.0,13427,0,18,-18
74016,1032,3508.0,13428,19,19,0
74017,722,3508.0,13429,19,18,1
74018,209,3508.0,13430,19,18,1
74019,201,3508.0,13431,19,17,2
74020,178,3508.0,13432,0,18,-18
74021,1033,3508.0,13433,19,18,1
74022,186,3508.0,13434,19,19,0
74023,723,3508.0,13435,19,18,1
74024,1034,3508.0,13436,19,18,1
74025,179,3508.0,13437,19,19,0
74026,202,3508.0,13438,19,18,1
74027,1035,3508.0,13439,19,19,0
74028,1034,3508.0,13440,19,19,0
74052,185,3508.0,13441,0,18,-18
74053,195,3508.0,13442,19,19,0
74106,185,3508.0,13443,0,18,-18
74313,1034,3508.0,13444,19,18,1
74314,175,3508.0,13445,0,18,-18
74315,215,3508.0,13446,19,19,0
74316,1036,3508.0,13447,19,19,0
74317,1035,3508.0,13448,19,20,-1
74330,1036,3508.0,13449,19,17,2
74331,1036,3508.0,13450,19,19,0
74332,193,3508.0,13451,0,18,-18
74409,198,3508.0,13452,19,19,0
74410,1031,3508.0,13453,19,19,0
74411,1032,3508.0,13454,19,18,1
74412,195,3508.0,13455,19,19,0
74413,1035,3508.0,13456,19,19,0
74414,939,3508.0,13457,19,18,1
74550,201,3508.0,13458,19,18,1
74563,721,3508.0,13459,19,17,2
74564,721,3508.0,13460,19,18,1
74565,187,3508.0,13461,19,16,3
74566,186,3508.0,13462,19,18,1
74872,176,3508.0,13463,19,19,0
75163,178,3508.0,13464,0,18,-18
75164,200,3508.0,13465,19,19,0
75165,200,3508.0,13466,19,20,-1
75166,193,3508.0,13467,0,19,-19
75785,1032,3508.0,13468,19,19,0
74415,851,3609.0,13469,19,18,1
74746,851,3609.0,13470,19,17,2
75223,197,3609.0,13471,19,19,0
75496,1033,3609.0,13472,19,19,0
75339,183,3724.0,13473,20,18,2
74544,1037,3725.0,13474,25,23,2
75787,1037,3725.0,13475,25,24,1
75788,210,3726.0,13476,25,25,0
75340,211,3840.0,13477,22,22,0
75789,211,3841.0,13478,15,11,4
74408,212,3942.0,13479,25,24,1
75790,1037,4103.0,13480,25,24,1
75791,1037,4103.0,13481,25,21,4
75341,196,4106.0,13482,25,25,0
75342,196,4154.0,13483,25,26,-1
75003,724,4202.0,13484,25,25,0
74828,197,4204.0,13485,25,24,1
75792,214,4244.0,13486,25,24,1
75168,215,4245.0,13487,25,25,0
75793,203,4246.0,13488,25,25,0
75017,216,4246.0,13489,20,17,3
74829,179,4274.0,13490,25,25,0
75794,210,4303.0,13491,25,18,7
75795,214,4333.0,13493,25,19,6
75796,206,4351.0,13494,25,21,4
75799,213,4370.0,13495,25,13,12
75800,939,4373.0,13496,25,14,11
75801,207,4392.0,13497,15,12,3
75802,213,4394.0,13498,15,15,0
75803,180,4397.0,13499,15,14,1
75804,192,4416.0,13500,15,15,0
74333,208,3496.0,13502,15,13,2
74176,217,3498.0,13503,15,15,0
74348,174,3499.0,13504,15,14,1
74130,853,3592.0,13507,15,15,0
75806,203,3595.0,13508,15,14,1
75808,853,3914.0,13509,15,11,4
74239,851,3915.0,13510,15,15,0
74899,174,4152.0,13519,25,19,6
74904,174,4153.0,13520,25,14,11
74914,174,4200.0,13522,25,19,6
74919,174,4201.0,13524,25,15,10
75137,727,3416.0,13534,15,15,0
75198,855,3416.0,13535,15,15,0
75495,855,3417.0,13536,25,15,10
75759,1038,3515.0,13537,25,24,1
75199,855,3518.0,13539,12,12,0
74586,727,3613.0,13540,15,14,1
74823,229,3734.0,13541,13,12,1
75362,727,4211.0,13546,15,12,3
74220,239,3346.0,13547,25,25,0
74221,239,3346.0,13548,26,25,1
74222,728,3346.0,13549,25,27,-2
74223,234,3346.0,13550,25,25,0
74224,235,3346.0,13551,25,25,0
74241,233,3346.0,13552,25,25,0
74541,233,3346.0,13553,25,25,0
74573,231,3346.0,13554,26,26,0
74981,942,3346.0,13555,25,25,0
75267,942,3346.0,13556,25,25,0
75626,238,3346.0,13557,25,26,-1
74268,1040,3413.0,13558,25,27,-2
75043,236,3413.0,13559,27,28,-1
74042,237,3414.0,13560,28,28,0
74043,237,3414.0,13561,28,29,-1
74831,942,3414.0,13562,28,29,-1
74843,238,3414.0,13563,28,28,0
74044,240,3415.0,13564,27,27,0
74110,240,3415.0,13565,25,26,-1
74244,236,3415.0,13566,25,27,-2
75268,236,3415.0,13567,26,27,-1
74308,728,3509.0,13568,26,26,0
74982,728,3509.0,13569,25,25,0
75178,231,3511.0,13570,15,14,1
75179,231,3511.0,13571,15,16,-1
74206,242,3513.0,13572,26,26,0
74574,242,3513.0,13573,26,23,3
74983,601,3610.0,13574,26,26,0
74984,601,3610.0,13575,26,26,0
75633,983,3842.0,13579,25,17,8
74654,243,3844.0,13580,18,16,2
74655,243,3844.0,13581,18,17,1
74656,240,3845.0,13582,25,22,3
74657,237,3947.0,13583,25,15,10
74658,242,3951.0,13584,25,15,10
75271,858,4038.0,13585,25,12,13
74058,859,,13587,35,19,16
74059,859,,13588,35,19,16
74060,859,,13589,35,13,22
74061,859,,13590,35,15,20
74062,859,,13591,35,25,10
74063,859,,13592,35,12,23
74064,859,,13593,35,21,14
74065,859,,13594,35,25,10
74066,859,,13595,35,22,13
74067,859,,13596,35,18,17
74068,859,,13597,35,21,14
74069,859,,13598,35,20,15
74070,859,,13599,35,25,10
74071,859,,13600,35,21,14
74072,859,,13601,35,19,16
74073,859,,13602,35,25,10
74074,859,,13603,35,24,11
74075,859,,13604,35,25,10
74076,859,,13605,35,25,10
74077,859,,13606,35,23,12
74078,859,,13607,35,22,13
74079,859,,13608,35,24,11
74080,859,,13609,35,21,14
74081,859,,13610,35,25,10
74082,859,,13611,35,23,12
74083,859,,13612,35,21,14
74084,859,,13613,35,22,13
74085,859,,13614,35,23,12
74086,859,,13615,35,26,9
74087,859,,13616,35,21,14
74088,859,,13617,35,21,14
74089,859,,13618,35,25,10
74090,859,,13619,35,23,12
74091,859,,13620,35,24,11
74092,859,,13621,35,22,13
74093,859,,13622,35,24,11
74094,859,,13623,35,22,13
74095,859,,13624,35,23,12
74096,859,,13625,35,23,12
74097,859,,13626,35,18,17
74098,859,,13627,35,23,12
74099,859,,13628,35,20,15
74100,859,,13629,35,24,11
74101,859,,13630,35,24,11
74102,859,,13631,35,20,15
75008,859,,13632,35,18,17
75009,859,,13633,35,19,16
75010,859,,13634,35,22,13
75011,859,,13635,35,25,10
75012,859,,13636,35,18,17
75473,859,,13638,30,11,19
75474,859,,13639,30,11,19
75475,859,,13640,30,12,18
74282,247,3205.0,13641,18,17,1
74283,247,3205.0,13642,18,16,2
74336,248,3205.0,13643,18,15,3
74549,248,3205.0,13644,18,16,2
74284,247,3280.0,13645,18,18,0
74285,249,3280.0,13646,18,17,1
74286,249,3280.0,13647,18,15,3
74294,253,3203.0,13651,18,15,3
75139,902,3124.0,13654,14,12,2
75101,985,3121.0,13656,25,26,-1
75646,985,3121.0,13657,25,26,-1
75866,258,,13661,26,23,3
75867,258,,13662,26,20,6
75868,602,,13663,26,26,0
75869,602,,13664,26,26,0
75870,602,,13665,26,25,1
75871,267,,13666,26,26,0
75872,267,,13667,26,26,0
75873,267,,13668,26,26,0
75874,915,,13669,26,27,-1
75875,915,,13670,26,25,1
75876,17,,13671,26,25,1
75877,17,,13672,26,26,0
75878,571,,13673,26,25,1
75879,259,,13674,26,25,1
75880,259,,13675,26,24,2
75881,256,,13676,0,25,-25
75882,261,,13677,26,26,0
75883,729,,13678,26,26,0
75884,260,,13679,26,25,1
75885,255,,13680,26,26,0
75886,255,,13681,26,25,1
75956,258,,13682,26,20,6
74581,261,3282.0,13683,25,24,1
75887,261,3282.0,13684,25,25,0
75888,260,3361.0,13685,25,25,0
75889,258,3365.0,13686,25,18,7
75890,96,3437.0,13687,20,22,-2
75891,1041,3535.0,13688,25,24,1
75892,729,3961.0,13689,25,24,1
75893,729,3961.0,13690,25,23,2
75894,256,3962.0,13691,25,25,0
75895,256,3963.0,13692,25,25,0
75896,571,4168.0,13693,25,23,2
75897,260,4248.0,13694,15,16,-1
75398,571,4337.0,13695,15,15,0
75898,259,4339.0,13696,15,13,2
75618,23,,13697,28,26,2
75619,368,,13698,28,26,2
75620,270,,13699,28,26,2
75661,271,,13700,28,27,1
75961,271,,13701,28,27,1
74144,288,3218.0,13702,20,18,2
74145,192,3218.0,13703,20,20,0
74154,93,3218.0,13704,15,16,-1
75622,180,3218.0,13705,20,17,3
75937,267,3218.0,13706,20,11,9
75624,55,,13708,30,29,1
74157,995,3077.0,13711,29,28,1
74158,684,3077.0,13712,25,27,-2
74159,995,3077.0,13713,29,27,2
74160,684,3077.0,13714,27,28,-1
74185,684,3077.0,13715,27,28,-1
74199,278,3077.0,13716,28,27,1
74631,278,3077.0,13717,26,26,0
74853,274,3077.0,13718,27,27,0
75042,274,3077.0,13719,25,25,0
74833,274,3140.0,13720,20,19,1
75299,431,3141.0,13721,20,22,-2
75778,431,3141.0,13722,20,20,0
75958,431,3141.0,13723,20,20,0
74147,995,3142.0,13724,20,18,2
74321,273,3143.0,13725,20,20,0
75779,273,3212.0,13726,20,20,0
75940,945,3296.0,13729,20,19,1
75899,280,2425.0,13736,20,16,4
74273,287,2351.0,13748,30,29,1
74959,287,2351.0,13749,30,19,11
74402,285,2372.0,13750,20,20,0
74274,22,2373.0,13751,15,14,1
74960,586,2374.0,13752,20,19,1
74128,287,2443.0,13754,10,12,-2
74287,864,2350.0,13756,18,17,1
74288,864,2350.0,13757,18,17,1
74289,864,2350.0,13758,18,13,5
74360,1042,2350.0,13759,18,18,0
74559,289,2350.0,13760,18,17,1
75214,289,2350.0,13761,18,18,0
74290,288,2370.0,13762,18,13,5
74291,288,2370.0,13763,18,15,3
74292,288,2370.0,13764,18,15,3
74293,986,2370.0,13765,18,16,2
75703,1042,2396.0,13767,18,18,0
74305,1043,2991.0,13770,20,11,9
74306,1043,2992.0,13771,30,12,18
74207,295,2957.0,13772,27,27,0
74208,295,2957.0,13773,28,28,0
74209,297,2957.0,13774,27,27,0
74210,297,2957.0,13775,27,26,1
74254,297,2957.0,13776,28,28,0
74270,294,2957.0,13777,27,27,0
74575,297,2957.0,13778,27,27,0
74973,294,2957.0,13779,28,28,0
74250,733,3012.0,13780,25,26,-1
74323,733,3012.0,13781,25,25,0
74148,299,3013.0,13782,26,28,-2
74180,299,3013.0,13783,26,26,0
74204,300,3014.0,13784,25,25,0
74205,302,3014.0,13785,25,25,0
74242,302,3014.0,13786,25,25,0
74271,302,3014.0,13787,26,26,0
74591,866,3014.0,13788,26,25,1
74605,866,3014.0,13789,25,26,-1
75106,300,3014.0,13790,27,22,5
75628,300,3014.0,13791,25,25,0
75630,295,3086.0,13792,25,14,11
74149,298,3149.0,13793,25,23,2
74251,299,3150.0,13794,25,15,10
74324,866,3151.0,13795,25,19,6
74272,733,3298.0,13797,25,17,8
75291,304,3376.0,13798,25,19,6
75097,71,3546.0,13802,20,19,1
74881,26,3640.0,13803,25,18,7
74659,304,3644.0,13804,25,18,7
74660,665,3746.0,13805,23,23,0
74661,10,3746.0,13806,26,26,0
74211,309,2959.0,13813,27,29,-2
74212,309,2959.0,13814,27,29,-2
74213,948,2959.0,13815,27,28,-1
74214,309,2959.0,13816,27,29,-2
74568,736,2959.0,13817,28,29,-1
74569,308,2959.0,13818,28,27,1
74570,307,2959.0,13819,28,28,0
74571,308,2959.0,13820,27,27,0
75261,311,2959.0,13821,27,28,-1
75692,307,2959.0,13822,27,29,-2
74186,310,3019.0,13823,28,27,1
74236,310,3019.0,13824,28,27,1
74252,310,3019.0,13825,28,28,0
74340,311,3020.0,13826,25,24,1
74341,311,3020.0,13827,25,25,0
74150,307,3021.0,13828,28,28,0
74342,867,3021.0,13829,28,26,2
75262,948,3022.0,13830,25,26,-1
75693,948,3022.0,13831,25,21,4
75088,736,3023.0,13832,25,25,0
75694,736,3023.0,13833,25,25,0
75090,307,3088.0,13834,25,25,0
74151,313,3089.0,13835,30,31,-1
75089,868,3089.0,13836,28,29,-1
75444,313,3089.0,13837,30,29,1
74161,613,3090.0,13838,25,25,0
74956,613,3090.0,13839,25,26,-1
75695,613,3090.0,13840,25,25,0
74163,906,3159.0,13841,25,24,1
74662,308,3308.0,13845,20,17,3
75696,309,3381.0,13846,20,20,0
75052,614,3403.0,13850,25,21,4
74697,321,3482.0,13852,21,22,-1
74698,321,3483.0,13853,20,14,6
74701,319,3572.0,13857,21,21,0
75447,319,3668.0,13865,24,23,1
74525,323,3015.0,13871,20,20,0
75150,949,3015.0,13873,20,22,-2
75151,873,3016.0,13874,20,20,0
75857,873,3016.0,13875,20,20,0
75152,333,3017.0,13876,25,24,1
75153,327,3017.0,13877,25,23,2
75154,327,3017.0,13878,25,26,-1
75155,580,3017.0,13879,25,26,-1
75858,580,3017.0,13880,25,25,0
74108,872,3018.0,13881,27,25,2
74126,347,3018.0,13882,27,26,1
74335,347,3018.0,13883,27,13,14
74753,1046,3018.0,13884,27,24,3
74610,615,3087.0,13885,30,27,3
74611,323,3087.0,13886,30,25,5
74612,341,3087.0,13887,30,31,-1
74613,874,3087.0,13888,30,31,-1
74614,874,3087.0,13889,30,29,1
74615,796,3087.0,13890,30,28,2
74616,159,3087.0,13891,30,28,2
74617,159,3087.0,13892,30,29,1
74618,343,3087.0,13893,30,27,3
74619,950,3087.0,13894,30,29,1
74629,342,3087.0,13895,30,28,2
74646,873,3087.0,13896,30,27,3
74751,343,3087.0,13897,30,27,3
74977,335,3087.0,13898,30,29,1
75156,873,3087.0,13899,30,25,5
75859,949,3087.0,13900,30,27,3
75998,1047,3087.0,13901,30,23,7
74518,350,3154.0,13902,25,23,2
74519,114,3154.0,13903,25,25,0
74978,350,3154.0,13904,25,26,-1
75157,114,3154.0,13905,25,22,3
74810,335,3226.0,13906,25,22,3
74520,1047,3227.0,13907,38,37,1
74521,333,3227.0,13908,38,32,6
74523,1046,3227.0,13909,38,34,4
75485,951,3227.0,13910,38,38,0
75487,580,3227.0,13911,38,32,6
75923,951,3227.0,13912,38,38,0
75991,159,3227.0,13913,38,31,7
74522,346,3228.0,13914,30,17,13
74133,349,3302.0,13915,28,27,1
74134,349,3302.0,13916,28,28,0
74142,739,3302.0,13917,28,29,-1
74143,739,3302.0,13918,28,27,1
74166,351,3302.0,13919,28,28,0
74647,351,3302.0,13920,28,28,0
75158,1047,3302.0,13921,28,20,8
75159,1047,3302.0,13922,28,25,3
75160,950,3302.0,13923,28,28,0
74809,346,3303.0,13924,25,14,11
74123,615,3304.0,13925,20,18,2
74621,343,3304.0,13926,20,17,3
74606,951,3379.0,13927,25,17,8
74607,334,3379.0,13928,25,26,-1
75161,334,3379.0,13929,25,18,7
74527,1046,3452.0,13930,25,18,7
74029,346,3547.0,13932,25,21,4
74030,344,3550.0,13933,20,15,5
75028,344,3550.0,13934,20,19,1
74109,345,3649.0,13935,25,21,4
74979,1048,3866.0,13937,15,14,1
74243,354,2881.0,13942,15,17,-2
74589,354,2881.0,13943,15,12,3
74532,363,2952.0,13944,15,12,3
74533,363,2952.0,13945,15,15,0
75205,875,2953.0,13946,15,24,-9
75206,875,2953.0,13947,15,23,-8
74200,167,3007.0,13948,15,14,1
75385,167,3007.0,13949,15,15,0
74051,356,3011.0,13950,15,17,-2
74836,357,3011.0,13951,15,14,1
75204,356,3139.0,13955,17,13,4
75443,356,3139.0,13956,17,18,-1
74141,361,3287.0,13957,17,12,5
75386,167,3287.0,13958,17,19,-2
74534,989,3288.0,13959,15,16,-1
75387,989,3288.0,13960,15,15,0
74670,358,3442.0,13961,15,15,0
74671,359,3443.0,13962,15,12,3
75224,784,3536.0,13963,15,13,2
75726,617,3637.0,13964,18,21,-3
75227,365,3344.0,13974,26,24,2
75765,364,3344.0,13975,25,25,0
75766,364,3344.0,13976,25,25,0
75967,365,3344.0,13977,25,22,3
74230,367,3407.0,13978,0,24,-24
75171,368,3407.0,13979,20,20,0
75767,368,3491.0,13980,25,25,0
74125,229,3576.0,13981,18,16,2
76016,271,3671.0,13983,20,19,1
75770,367,3675.0,13985,25,25,0
74056,371,3776.0,13987,50,11,39
74168,380,2990.0,13991,36,36,0
75301,372,2990.0,13992,36,27,9
74169,373,3055.0,13993,44,33,11
74877,419,3055.0,13994,44,39,5
74428,1004,3127.0,13996,42,41,1
75302,1004,3127.0,13997,42,42,0
74170,1004,3193.0,14009,43,41,2
74590,1004,3193.0,14010,43,40,3
74946,385,3193.0,14011,43,43,0
75814,377,3193.0,14012,60,56,4
74171,374,3195.0,14013,47,47,0
74190,389,3195.0,14014,47,46,1
74592,389,3195.0,14015,47,38,9
75304,374,3195.0,14016,60,57,3
74172,619,3196.0,14017,42,41,1
74593,1050,3196.0,14018,60,56,4
74173,399,3265.0,14038,64,65,-1
75823,399,3265.0,14039,64,58,6
74464,385,3266.0,14040,20,18,2
74465,380,3266.0,14041,20,16,4
74466,380,3266.0,14042,20,20,0
74467,1051,3266.0,14043,20,20,0
74468,377,3266.0,14044,20,16,4
75824,385,3266.0,14045,20,18,2
75825,380,3266.0,14046,20,15,5
74598,387,3333.0,14048,60,57,3
74307,876,3401.0,14057,30,26,4
75827,379,3401.0,14058,31,31,0
74191,372,3480.0,14068,31,30,1
75829,409,3480.0,14069,31,32,-1
74192,422,3569.0,14081,45,43,2
74193,422,3569.0,14082,45,45,0
74731,419,3766.0,14097,25,20,5
76004,419,3766.0,14098,20,16,4
74733,634,3980.0,14100,25,20,5
74747,421,3982.0,14101,30,24,6
74633,409,4063.0,14103,25,20,5
75310,619,4063.0,14104,25,19,6
74634,423,4066.0,14106,40,38,2
74635,1056,4124.0,14107,25,24,1
75972,1056,4124.0,14108,25,25,0
74748,389,4126.0,14109,50,49,1
74636,389,4128.0,14110,25,24,1
74637,957,4177.0,14111,25,23,2
74638,957,4178.0,14112,25,23,2
75815,927,4253.0,14115,17,16,1
75019,420,4285.0,14117,15,15,0
74642,426,4287.0,14118,50,27,23
74643,420,4287.0,14119,30,29,1
74894,420,4315.0,14120,15,14,1
75018,422,4317.0,14122,25,20,5
74644,420,2826.0,14123,15,15,0
74645,420,2892.0,14124,15,14,1
75020,429,2956.0,14125,15,15,0
74215,275,2683.0,14130,25,24,1
74216,275,2683.0,14131,25,25,0
74217,912,2683.0,14132,25,25,0
74218,912,2683.0,14133,25,26,-1
74219,995,2683.0,14134,25,16,9
74832,430,2683.0,14135,25,26,-1
74935,430,2683.0,14136,25,26,-1
75300,958,2683.0,14137,25,25,0
74376,436,2685.0,14138,25,25,0
74377,443,2685.0,14139,25,23,2
74378,435,2685.0,14140,25,23,2
74379,435,2685.0,14141,25,25,0
74380,434,2685.0,14142,25,25,0
74381,436,2685.0,14143,25,26,-1
74382,443,2685.0,14144,25,24,1
74383,443,2685.0,14145,25,24,1
74385,438,2685.0,14146,25,25,0
74386,959,2685.0,14147,25,24,1
74387,440,2685.0,14148,25,25,0
74389,434,2685.0,14149,25,25,0
74390,879,2685.0,14150,25,25,0
74427,451,2685.0,14151,25,24,1
74547,754,2685.0,14152,25,25,0
74548,754,2685.0,14153,25,25,0
75049,879,2685.0,14154,25,21,4
75102,879,2685.0,14155,25,24,1
75970,1057,2685.0,14156,25,24,1
75978,1058,2685.0,14157,25,25,0
75979,1058,2685.0,14158,25,24,1
74392,880,2758.0,14159,20,18,2
74393,880,2758.0,14160,20,20,0
74394,1059,2760.0,14161,20,21,-1
75402,1059,2760.0,14162,20,18,2
75663,434,2815.0,14163,20,21,-1
74395,442,2817.0,14164,20,19,1
74560,442,2817.0,14165,20,20,0
75441,913,2875.0,14166,20,21,-1
74623,913,2877.0,14167,20,20,0
75664,443,2935.0,14168,20,20,0
75665,441,2937.0,14169,20,19,1
75666,441,2939.0,14170,20,15,5
74561,450,2984.0,14171,20,22,-2
74562,450,2984.0,14172,20,20,0
74396,1060,2987.0,14173,20,19,1
74397,1060,2987.0,14174,20,15,5
74398,449,2989.0,14175,20,20,0
74399,449,2989.0,14176,20,18,2
75667,879,3050.0,14177,20,18,2
74971,438,3113.0,14178,20,19,1
75405,438,3113.0,14179,20,20,0
75783,436,,14181,20,14,6
75407,755,2684.0,14184,24,15,9
75124,457,2754.0,14185,24,24,0
75959,457,2754.0,14186,24,22,2
75527,459,2755.0,14187,20,20,0
75697,458,2812.0,14188,24,23,1
75180,455,2813.0,14189,24,25,-1
75182,454,2813.0,14190,24,26,-2
75183,455,2813.0,14191,24,19,5
75184,755,2813.0,14192,24,25,-1
75185,1061,2813.0,14193,24,24,0
75408,457,2813.0,14194,24,25,-1
75186,1061,2814.0,14195,24,21,3
75188,457,2814.0,14197,24,22,2
75189,459,2814.0,14198,24,24,0
75190,755,2814.0,14199,24,24,0
75191,755,2814.0,14200,24,22,2
75192,1062,2814.0,14201,24,21,3
74319,455,3044.0,14203,20,18,2
74031,454,3045.0,14204,20,13,7
75839,1063,,14209,25,21,4
75840,464,,14210,25,23,2
75841,464,,14211,0,24,-24
75842,465,,14212,25,18,7
75843,465,,14213,25,14,11
75845,464,,14215,25,15,10
75846,465,,14216,25,25,0
75848,1063,,14217,25,18,7
75849,1063,,14218,25,19,6
75851,1064,,14219,25,25,0
75852,285,,14220,25,24,1
75854,285,,14221,25,18,7
75704,654,2764.0,14223,18,11,7
74035,883,2745.0,14225,30,25,5
74140,883,2745.0,14226,30,29,1
74257,473,2745.0,14227,30,26,4
74936,472,2745.0,14228,0,26,-26
75037,960,2745.0,14229,30,30,0
75968,1065,2745.0,14230,30,30,0
74735,470,2746.0,14231,1,23,-22
74812,470,2746.0,14232,0,21,-21
75110,638,2746.0,14233,1,25,-24
75656,806,2810.0,14234,0,13,-13
74736,638,2811.0,14235,0,21,-21
74741,476,2811.0,14236,0,19,-19
74737,638,2867.0,14237,0,11,-11
74742,960,2868.0,14241,0,14,-14
74813,473,2868.0,14242,0,13,-13
75657,472,2868.0,14243,0,12,-12
74745,638,2870.0,14244,0,19,-19
74743,474,2928.0,14245,0,24,-24
74744,960,2930.0,14246,0,23,-23
75282,638,2974.0,14247,0,20,-20
74814,469,2977.0,14248,0,27,-27
74037,476,3040.0,14249,0,24,-24
75658,1065,3040.0,14250,0,24,-24
74036,480,3042.0,14251,0,23,-23
74175,1065,3042.0,14252,20,16,4
75659,1065,3043.0,14253,0,18,-18
75111,480,3104.0,14254,0,18,-18
74815,474,3178.0,14259,0,13,-13
75660,469,3252.0,14260,0,16,-16
74947,474,3324.0,14261,0,11,-11
74711,482,3474.0,14265,20,13,7
74713,757,3476.0,14267,12,12,0
75047,757,3476.0,14268,12,11,1
75210,484,3477.0,14269,20,15,5
74714,484,3478.0,14270,20,12,8
74715,544,3565.0,14271,20,12,8
74717,485,3760.0,14274,15,11,4
74718,483,3761.0,14275,15,11,4
75013,482,4058.0,14278,20,11,9
75401,130,2586.0,14280,15,18,-3
75149,132,2629.0,14281,15,14,1
75818,1066,,14285,50,14,36
75901,1016,,14286,50,19,31
75782,430,2527.0,14287,20,27,-7
75516,691,2573.0,14288,10,12,-2
75513,961,2670.0,14290,20,21,-1
74727,962,2702.0,14291,26,24,2
75465,962,2702.0,14292,26,26,0
75670,642,2703.0,14293,26,22,4
75671,642,2703.0,14294,26,26,0
74419,272,2704.0,14295,0,23,-23
74420,272,2704.0,14296,26,25,1
74421,493,2704.0,14297,26,25,1
74540,493,2704.0,14298,26,26,0
74628,643,2704.0,14299,26,25,1
74817,643,2704.0,14300,26,26,0
74818,1067,2704.0,14301,26,25,1
75927,1067,2704.0,14302,26,24,2
74422,496,2778.0,14303,26,23,3
74423,496,2778.0,14304,26,24,2
74758,496,2778.0,14305,26,24,2
74819,497,2778.0,14306,25,23,2
74820,497,2778.0,14307,26,24,2
75098,497,2778.0,14308,25,22,3
74424,963,2779.0,14309,26,26,0
74425,963,2779.0,14310,26,25,1
75997,963,2779.0,14311,26,26,0
75083,492,2779.0,14312,20,18,2
75672,499,2779.0,14313,20,20,0
75673,499,2779.0,14314,20,20,0
74426,500,2840.0,14315,25,25,0
75674,501,2842.0,14316,25,25,0
75675,501,2899.0,14317,25,24,1
75676,886,2960.0,14318,20,19,1
75686,997,3024.0,14319,25,24,1
75678,496,3027.0,14320,25,22,3
75415,915,3029.0,14321,20,19,1
75679,272,3091.0,14322,25,25,0
74539,998,3092.0,14323,25,25,0
75431,644,3093.0,14324,25,27,-2
75036,645,3163.0,14325,20,19,1
75928,643,3236.0,14326,20,19,1
74821,505,3237.0,14327,25,24,1
75680,493,3239.0,14328,25,24,1
75681,503,,14329,25,25,0
75682,503,,14330,25,23,2
75683,494,3386.0,14331,25,22,3
75684,494,3386.0,14332,25,20,5
75685,642,3388.0,14333,25,25,0
75929,1067,3557.0,14334,20,16,4
74038,648,2497.0,14339,28,28,0
74124,648,2497.0,14340,28,27,1
74555,251,2497.0,14341,28,18,10
74864,509,2497.0,14342,25,17,8
75277,1068,2497.0,14343,28,28,0
74556,251,2590.0,14344,28,27,1
75688,1068,2590.0,14345,28,25,3
74345,507,2591.0,14346,28,30,-2
74400,507,2591.0,14347,27,27,0
75652,764,2592.0,14348,28,22,6
75653,764,2648.0,14349,28,26,2
74337,251,2650.0,14350,28,28,0
74604,251,2711.0,14351,28,20,8
74184,510,2787.0,14353,20,13,7
75655,507,2789.0,14354,28,25,3
75281,1068,2848.0,14355,28,18,10
74356,509,2849.0,14356,25,19,6
74247,511,2488.0,14360,22,23,-1
74873,511,2580.0,14363,15,15,0
74668,514,2582.0,14365,15,13,2
75730,515,2623.0,14366,20,11,9
74669,706,2624.0,14367,24,25,-1
75931,519,,14368,20,11,9
75388,917,2676.0,14369,11,12,-1
75731,1023,2742.0,14370,30,24,6
74854,520,2862.0,14371,20,12,8
74295,654,2502.0,14376,18,18,0
74296,918,2502.0,14377,18,17,1
74297,918,2502.0,14378,18,17,1
74298,765,2502.0,14379,18,18,0
74870,765,2502.0,14380,18,18,0
74871,655,2502.0,14381,18,18,0
75050,655,2502.0,14382,18,14,4
75051,524,2502.0,14383,18,16,2
75194,524,2502.0,14384,18,16,2
75486,999,2502.0,14385,18,15,3
76005,530,2502.0,14386,18,15,3
74993,767,2549.0,14388,18,18,0
74994,767,2549.0,14389,18,18,0
74995,964,2549.0,14390,18,19,-1
74996,964,2549.0,14391,18,17,1
74997,811,2549.0,14392,18,18,0
74998,811,2549.0,14393,18,16,2
74999,536,2549.0,14394,18,18,0
75000,536,2549.0,14395,18,15,3
75001,529,2549.0,14396,18,17,1
74299,534,2551.0,14397,18,18,0
74300,534,2551.0,14398,18,17,1
74301,1069,2551.0,14399,19,18,1
74302,1069,2551.0,14400,19,19,0
74303,535,2551.0,14401,19,16,3
74304,531,2551.0,14402,19,16,3
74848,527,2551.0,14403,19,20,-1
74859,527,2551.0,14404,19,12,7
75024,538,2551.0,14405,19,17,2
75116,527,2551.0,14406,19,14,5
76007,530,2551.0,14407,18,15,3
75117,531,2593.0,14408,18,18,0
75118,531,2593.0,14409,18,18,0
75119,964,2593.0,14410,18,19,-1
75120,964,2593.0,14411,18,16,2
74486,527,2594.0,14412,17,14,3
74487,524,2594.0,14413,17,13,4
75220,523,2594.0,14414,17,14,3
75706,523,2652.0,14415,15,13,2
75002,524,2653.0,14416,15,12,3
75708,538,2655.0,14418,15,13,2
75333,535,2656.0,14419,15,14,1
75709,535,2720.0,14420,15,13,2
75176,656,2635.0,14424,20,12,8
75479,541,2637.0,14425,20,16,4
74721,151,2691.0,14426,20,11,9
75177,965,2695.0,14428,20,13,7
75480,889,2831.0,14431,18,17,1
76013,658,2831.0,14432,18,18,0
74138,546,2496.0,14436,18,18,0
75771,546,2496.0,14437,18,18,0
74246,660,2537.0,14438,16,16,0
75772,548,2538.0,14439,18,18,0
75143,548,2540.0,14440,18,18,0
75144,548,2540.0,14441,18,18,0
75773,812,2541.0,14442,18,15,3
74988,545,2588.0,14443,18,17,1
75368,812,2589.0,14444,18,18,0
74339,660,2639.0,14445,16,16,0
75774,549,2642.0,14446,15,15,0
75172,550,2643.0,14447,15,15,0
75015,542,2482.0,14452,10,11,-1
76001,542,2482.0,14453,15,16,-1
75087,12,2421.0,14462,23,18,5
74845,557,2457.0,14463,23,16,7
74663,12,2458.0,14464,23,26,-3
74664,12,2458.0,14465,28,28,0
74933,664,2504.0,14466,23,21,2
74249,558,2391.0,14467,24,19,5
75141,561,2391.0,14468,24,23,1
74137,559,2426.0,14469,16,13,3
74990,20,2427.0,14471,50,12,38
75775,1071,2427.0,14472,20,12,8
74991,1072,2428.0,14473,50,19,31
75776,20,2466.0,14476,24,14,10
37364,11,2333.0,14483,26,27,-1
37723,11,2333.0,14484,26,27,-1
37079,2,2355.0,14485,32,32,0
37155,2,2355.0,14486,32,29,3
37171,8,2355.0,14487,32,31,1
37174,1,2355.0,14488,32,32,0
37256,1,2355.0,14489,32,32,0
37365,4,2355.0,14490,32,32,0
37366,4,2355.0,14491,32,32,0
37510,4,2355.0,14492,32,32,0
37549,5,2355.0,14493,32,32,0
37550,5,2355.0,14494,32,32,0
37551,15,2355.0,14495,32,32,0
37682,15,2355.0,14496,32,31,1
38736,1011,2355.0,14497,32,29,3
38738,1074,2355.0,14498,32,32,0
39035,1011,2355.0,14499,32,32,0
37129,10,2356.0,14500,24,16,8
37032,9,2357.0,14501,28,27,1
37062,9,2357.0,14502,28,29,-1
37257,9,2357.0,14503,28,27,1
37367,6,2377.0,14504,16,14,2
38739,6,2377.0,14505,22,12,10
37137,772,2378.0,14506,27,26,1
37216,772,2378.0,14507,27,25,2
37295,8,2379.0,14508,25,25,0
37553,8,2379.0,14509,25,25,0
37212,773,2381.0,14510,29,33,-4
37218,12,2407.0,14511,31,33,-2
39011,1,2494.0,14518,25,17,8
37517,11,2534.0,14519,25,29,-4
37646,1075,2535.0,14520,25,27,-2
37518,3,2536.0,14521,15,24,-9
38151,3,2536.0,14522,15,17,-2
38152,774,2583.0,14524,24,16,8
37355,21,2246.0,14535,28,28,0
37495,775,2248.0,14538,28,28,0
37663,775,2248.0,14539,28,28,0
37938,23,2249.0,14540,20,21,-1
39139,23,2249.0,14541,20,21,-1
37805,24,2250.0,14542,25,24,1
38842,24,2250.0,14543,25,25,0
38843,832,2252.0,14544,25,22,3
37806,22,2259.0,14545,20,19,1
37231,25,2303.0,14548,30,30,0
37563,25,2318.0,14549,30,30,0
37286,26,2335.0,14550,30,23,7
37232,27,2336.0,14551,30,30,0
38360,696,2338.0,14552,30,28,2
37154,29,2358.0,14554,30,29,1
37898,696,2358.0,14555,30,30,0
37164,30,2360.0,14556,36,35,1
37110,31,2383.0,14557,30,30,0
37848,15,2383.0,14558,30,31,-1
37849,1014,2383.0,14559,30,29,1
37850,569,2383.0,14560,30,30,0
39023,569,2383.0,14561,30,30,0
37851,34,2383.0,14562,20,17,3
37852,34,2383.0,14563,20,20,0
38045,32,2383.0,14564,20,20,0
37169,36,2286.0,14567,25,25,0
38159,36,2286.0,14568,25,25,0
37068,37,2295.0,14570,25,16,9
37069,37,2295.0,14571,25,24,1
37070,37,2295.0,14572,25,23,2
39120,40,2295.0,14573,20,19,1
38752,42,2296.0,14574,25,25,0
38753,42,2297.0,14575,25,25,0
38754,37,2306.0,14576,25,12,13
38755,38,2324.0,14577,20,22,-2
38164,40,2343.0,14578,25,15,10
38756,894,2364.0,14579,25,25,0
38297,896,2234.0,14585,12,12,0
37037,833,2392.0,14586,24,24,0
37948,833,2392.0,14587,24,18,6
37210,45,2393.0,14588,24,23,1
37564,45,2393.0,14589,24,24,0
37949,54,2393.0,14590,24,22,2
38686,47,2395.0,14591,24,21,3
38687,47,2395.0,14592,24,23,1
37328,62,2431.0,14593,24,23,1
39014,61,2433.0,14594,24,23,1
37698,1015,2434.0,14595,24,24,0
37699,1015,2434.0,14596,24,23,1
38688,572,2471.0,14597,28,29,-1
37038,51,2474.0,14598,92,90,2
37499,52,2474.0,14599,92,72,20
38689,51,2474.0,14600,73,42,31
37329,836,2518.0,14601,20,19,1
37330,51,2518.0,14602,20,20,0
37331,52,2518.0,14603,20,20,0
37332,52,2518.0,14604,20,20,0
37333,836,2518.0,14605,20,20,0
37700,51,2518.0,14607,20,20,0
37950,52,2518.0,14608,20,20,0
37951,834,2518.0,14609,20,17,3
38199,836,2518.0,14610,20,20,0
38690,836,2518.0,14611,20,19,1
37133,698,2519.0,14612,40,40,0
38200,698,2519.0,14613,40,24,16
37335,698,2520.0,14614,16,16,0
37685,835,2520.0,14615,16,16,0
38201,1076,2520.0,14616,16,16,0
38691,698,2520.0,14617,16,16,0
37134,64,2567.0,14618,56,54,2
37336,64,2567.0,14619,56,40,16
37338,56,2606.0,14620,14,12,2
37339,67,2606.0,14621,14,14,0
37340,573,2606.0,14622,14,14,0
37341,60,2606.0,14623,14,14,0
37952,57,2606.0,14624,14,15,-1
38692,56,2606.0,14625,14,11,3
38693,67,2606.0,14626,14,14,0
38694,58,2607.0,14637,10,11,-1
38696,68,2724.0,14643,24,24,0
38697,68,2725.0,14644,12,12,0
38698,61,2795.0,14645,16,11,5
38699,61,2796.0,14646,16,11,5
37290,55,2797.0,14647,43,43,0
37342,55,2798.0,14648,16,16,0
37343,55,2798.0,14649,15,16,-1
38700,573,2921.0,14651,16,12,4
38701,1016,2922.0,14652,20,15,5
38702,56,3102.0,14657,20,16,4
37156,70,2223.0,14670,25,24,1
37157,70,2223.0,14671,25,25,0
37158,69,2223.0,14672,25,13,12
37159,69,2223.0,14673,25,23,2
37557,702,2223.0,14674,25,25,0
37794,702,2223.0,14675,25,25,0
37795,70,2223.0,14676,25,25,0
38744,71,2223.0,14677,25,25,0
38745,71,2223.0,14678,25,25,0
37175,70,2224.0,14679,25,16,9
39033,668,,14681,100,11,89
39006,275,,14693,32,34,-2
39007,1077,,14694,30,30,0
39008,684,,14695,30,21,9
37908,86,3999.0,14696,24,24,0
37119,78,4003.0,14697,30,31,-1
38221,78,4003.0,14698,30,31,-1
38811,838,4003.0,14699,30,34,-4
37345,76,4077.0,14700,14,16,-2
37346,838,4077.0,14701,14,15,-1
37566,78,4077.0,14702,14,16,-2
37651,76,4077.0,14703,14,15,-1
37969,78,4077.0,14704,14,16,-2
38812,1019,4077.0,14705,14,15,-1
38879,80,4078.0,14706,24,24,0
37299,81,4079.0,14707,20,19,1
37970,86,4080.0,14708,24,24,0
37502,83,4141.0,14709,30,30,0
37503,84,4141.0,14710,30,30,0
37504,701,4141.0,14711,32,33,-1
37710,83,4141.0,14712,30,23,7
37505,88,4190.0,14713,16,14,2
37506,839,4190.0,14714,16,15,1
37507,93,4190.0,14715,16,15,1
37508,88,4190.0,14716,16,15,1
37509,84,4190.0,14717,16,15,1
37809,84,4190.0,14718,14,12,2
37971,1078,4190.0,14719,16,12,4
37042,80,4193.0,14722,25,19,6
37972,65,4193.0,14724,25,25,0
37347,65,4234.0,14725,15,16,-1
37348,91,4234.0,14726,15,14,1
37349,92,4234.0,14727,15,11,4
37350,80,4234.0,14728,15,12,3
37044,93,4235.0,14729,12,12,0
37565,93,4236.0,14730,12,12,0
37236,85,4268.0,14731,20,14,6
37211,701,4270.0,14734,15,15,0
37243,94,3825.0,14743,18,11,7
37726,1020,3823.0,14745,25,26,-1
37853,1020,3823.0,14746,25,25,0
37100,1079,3784.0,14751,26,23,3
37144,1080,3784.0,14752,26,25,1
37584,1081,3784.0,14753,26,25,1
37075,1021,3890.0,14754,16,16,0
37135,1021,3890.0,14755,16,16,0
37168,100,3890.0,14756,16,15,1
37360,101,3890.0,14757,16,16,0
37799,1081,3891.0,14758,26,22,4
37235,841,3892.0,14759,26,25,1
37273,841,3892.0,14760,26,26,0
37285,935,3892.0,14761,26,26,0
37076,98,3988.0,14762,26,28,-2
37152,98,3988.0,14763,26,26,0
37683,98,3989.0,14764,26,28,-2
37684,1081,3991.0,14765,26,21,5
38832,97,4068.0,14766,26,27,-1
38361,111,4130.0,14767,26,26,0
38833,109,4133.0,14768,26,24,2
38834,1022,4180.0,14769,26,27,-1
37153,110,4181.0,14770,19,18,1
37424,97,4181.0,14771,19,19,0
39039,1081,4181.0,14772,19,18,1
37803,110,4223.0,14773,25,24,1
38835,841,4258.0,14774,20,19,1
37746,111,4290.0,14775,17,15,2
37686,110,4291.0,14776,25,28,-3
38836,109,,14777,20,19,1
38837,935,,14778,17,16,1
37914,98,4344.0,14780,30,26,4
37521,30,4365.0,14781,18,20,-2
38840,111,4425.0,14785,15,15,0
38841,1022,,14786,13,12,1
37708,162,3588.0,14794,20,19,1
37828,162,3588.0,14795,20,19,1
37702,112,3692.0,14796,14,15,-1
37709,112,3692.0,14797,14,13,1
38299,888,3587.0,14801,22,22,0
37753,706,3687.0,14802,21,22,-1
37763,972,3687.0,14803,15,13,2
38083,972,3687.0,14804,21,20,1
39059,706,3687.0,14805,15,15,0
38881,1023,3691.0,14807,22,19,3
38882,1023,3691.0,14808,15,15,0
38883,1023,3790.0,14809,22,21,1
38884,1023,3790.0,14810,15,14,1
38885,520,,14812,20,14,6
38887,706,3898.0,14814,20,12,8
37127,125,3704.0,14817,20,13,7
37092,116,3808.0,14820,20,23,-3
37163,117,3911.0,14822,20,13,7
38968,122,3912.0,14823,20,12,8
37051,115,4086.0,14825,12,12,0
38969,117,4091.0,14828,20,11,9
37641,118,4148.0,14830,13,14,-1
38087,131,3589.0,14836,25,25,0
37085,709,3697.0,14837,25,25,0
37086,134,3697.0,14838,25,26,-1
37087,586,3697.0,14839,25,23,2
37088,710,3697.0,14840,25,25,0
37148,133,3697.0,14841,25,25,0
37181,133,3697.0,14842,25,25,0
37259,133,3697.0,14843,25,25,0
37287,133,3697.0,14844,25,23,2
37288,127,3697.0,14845,25,25,0
37358,132,3697.0,14846,25,25,0
37496,132,3697.0,14847,25,25,0
37497,75,3697.0,14848,25,25,0
37605,129,3697.0,14849,25,25,0
37606,134,3697.0,14850,25,24,1
37607,710,3697.0,14851,25,25,0
37725,1024,3697.0,14852,25,26,-1
38027,1024,3697.0,14853,25,25,0
38028,1024,3697.0,14854,25,25,0
38029,129,3697.0,14855,25,25,0
38713,1024,3697.0,14856,25,24,1
39117,710,3697.0,14857,25,24,1
38362,132,3697.0,14858,20,20,0
37745,131,3801.0,14859,25,24,1
38031,130,3802.0,14860,25,25,0
38714,130,3802.0,14861,25,26,-1
37130,709,3906.0,14863,25,18,7
37815,127,4007.0,14865,25,25,0
38241,130,4084.0,14866,25,25,0
37024,131,4194.0,14870,25,15,10
37297,976,3586.0,14871,20,25,-5
37182,589,3681.0,14872,20,21,-1
37025,145,3682.0,14873,23,23,0
38971,936,3682.0,14874,20,19,1
37113,889,3683.0,14875,20,17,3
37715,977,3685.0,14876,20,11,9
37056,936,3787.0,14877,20,15,5
38068,153,3788.0,14879,20,12,8
37871,1083,3894.0,14880,20,18,2
39057,145,4189.0,14883,20,16,4
39051,977,,14908,60,55,5
37057,816,3603.0,14909,20,19,1
38978,714,3607.0,14910,20,13,7
38329,817,3608.0,14911,20,12,8
38980,155,4029.0,14914,20,14,6
37209,166,3493.0,14921,15,11,4
37980,112,3419.0,14925,15,16,-1
37981,899,3420.0,14926,20,20,0
37982,899,3420.0,14927,20,18,2
37983,899,3420.0,14928,20,20,0
38892,707,3421.0,14929,15,17,-2
38893,707,3421.0,14930,15,18,-3
38894,784,3421.0,14931,15,12,3
38895,707,3422.0,14932,15,14,1
38896,707,3422.0,14933,15,18,-3
38897,784,3422.0,14934,15,15,0
37985,163,3520.0,14935,20,12,8
37707,167,3620.0,14937,60,62,-2
37586,188,3508.0,14938,19,20,-1
37001,209,3609.0,14939,19,19,0
37002,178,3609.0,14940,19,18,1
37003,176,3609.0,14941,19,19,0
37004,851,3609.0,14942,19,19,0
37005,723,3609.0,14943,19,19,0
37006,186,3609.0,14944,19,19,0
37007,175,3609.0,14945,19,19,0
37008,188,3609.0,14946,19,19,0
37009,195,3609.0,14947,19,20,-1
37010,721,3609.0,14948,19,19,0
37011,1036,3609.0,14949,19,18,1
37012,721,3609.0,14950,19,17,2
37013,722,3609.0,14951,19,19,0
37014,1035,3609.0,14952,19,19,0
37015,187,3609.0,14953,19,21,-2
37016,1032,3609.0,14954,19,19,0
37017,198,3609.0,14955,19,19,0
37018,193,3609.0,14956,19,19,0
37019,851,3609.0,14957,19,19,0
37020,1036,3609.0,14958,19,19,0
37021,723,3609.0,14959,19,19,0
37022,900,3609.0,14960,19,19,0
37026,1032,3609.0,14961,19,19,0
37060,1032,3609.0,14962,19,19,0
37061,185,3609.0,14963,19,19,0
37065,185,3609.0,14964,19,19,0
37066,1036,3609.0,14965,19,19,0
37074,939,3609.0,14966,19,19,0
37089,900,3609.0,14967,19,19,0
37094,851,3609.0,14968,19,19,0
37095,178,3609.0,14969,19,19,0
37096,1033,3609.0,14970,19,19,0
37097,218,3609.0,14971,19,19,0
37098,195,3609.0,14972,19,19,0
37179,1033,3609.0,14973,19,19,0
37183,1034,3609.0,14974,19,19,0
37239,201,3609.0,14975,19,19,0
37427,186,3609.0,14976,19,20,-1
37428,198,3609.0,14977,19,19,0
37597,722,3609.0,14978,19,19,0
37598,209,3609.0,14979,19,19,0
37599,209,3609.0,14980,19,19,0
37992,175,3609.0,14981,19,19,0
37993,1034,3609.0,14982,19,19,0
37994,1034,3609.0,14983,19,19,0
37995,193,3609.0,14984,19,19,0
37996,173,3609.0,14985,19,19,0
37997,1035,3609.0,14986,19,19,0
37998,1035,3609.0,14987,19,19,0
37999,19,3724.0,14988,25,23,2
37528,19,3725.0,14989,25,17,8
37854,19,3725.0,14990,20,21,-1
38941,1037,3943.0,14991,25,25,0
38942,1037,3943.0,14992,25,25,0
38943,1037,3943.0,14993,25,13,12
38945,213,4037.0,14995,25,23,2
38946,196,4106.0,14996,25,23,2
38947,1043,4107.0,14997,25,23,2
38948,1043,4107.0,14998,25,19,6
38949,196,4154.0,14999,25,25,0
38950,192,4155.0,15000,25,24,1
38952,206,4156.0,15001,25,25,0
37855,724,4202.0,15002,25,26,-1
38953,180,4206.0,15003,25,24,1
38954,210,4243.0,15004,25,23,2
37818,216,4246.0,15005,20,20,0
38002,180,4304.0,15006,25,25,0
38956,213,4335.0,15007,25,21,4
38957,179,4374.0,15008,25,23,2
38958,206,4396.0,15009,15,15,0
38959,210,4407.0,15010,15,18,-3
38960,1037,4418.0,15011,15,13,2
37727,214,4420.0,15012,15,13,2
37099,853,3592.0,15018,15,16,-1
37276,218,3593.0,15019,15,14,1
37676,179,3710.0,15021,15,12,3
37538,203,3809.0,15022,15,12,3
37589,851,3915.0,15024,15,11,4
37677,193,4017.0,15025,15,11,4
38964,853,,15026,15,14,1
38682,174,4152.0,15035,30,20,10
38683,174,4153.0,15036,30,14,16
38669,174,4200.0,15038,30,21,9
38671,174,4201.0,15040,30,14,16
38757,1086,3347.0,15047,25,25,0
38758,1087,3347.0,15048,25,24,1
37581,727,3416.0,15049,15,15,0
38037,727,3416.0,15050,15,15,0
38759,1086,3418.0,15052,25,18,7
37583,855,3519.0,15053,15,15,0
39022,727,3956.0,15054,20,20,0
37185,234,3346.0,15058,20,21,-1
37186,234,3346.0,15059,20,20,0
37187,239,3346.0,15060,20,20,0
37188,239,3346.0,15061,20,20,0
37716,235,3346.0,15062,20,20,0
38145,238,3346.0,15063,20,20,0
38146,232,3346.0,15064,20,12,8
37556,1040,3413.0,15065,25,23,2
37766,1040,3413.0,15066,25,23,2
37078,231,3414.0,15067,28,29,-1
37103,231,3414.0,15068,28,17,11
37718,942,3414.0,15069,28,28,0
38147,942,3414.0,15070,28,28,0
37033,240,3415.0,15071,28,26,2
37112,236,3415.0,15072,28,27,1
37650,236,3415.0,15073,28,28,0
37213,728,3509.0,15074,25,25,0
37219,728,3509.0,15075,25,25,0
38740,858,3510.0,15076,25,22,3
37160,233,3512.0,15077,25,24,1
37166,233,3512.0,15078,25,20,5
37945,240,3611.0,15079,25,25,0
38741,240,3611.0,15080,25,25,0
37034,601,3612.0,15081,28,13,15
37064,601,3612.0,15082,28,27,1
37138,857,3612.0,15083,28,28,0
37719,857,3612.0,15084,28,28,0
37946,857,3612.0,15085,28,29,-1
37720,243,3612.0,15086,21,21,0
37906,983,3733.0,15090,20,18,2
38742,236,3845.0,15095,25,12,13
37093,233,3948.0,15096,25,16,9
38743,728,3949.0,15097,25,12,13
37411,942,4109.0,15099,25,11,14
39064,1089,,15102,20,13,7
37245,247,3279.0,15104,18,15,3
37293,247,3279.0,15105,18,18,0
37747,248,3279.0,15107,18,11,7
37246,247,3281.0,15108,18,18,0
37247,249,3281.0,15109,18,12,6
37248,249,3281.0,15110,18,17,1
37240,253,3275.0,15118,18,16,2
38039,902,3125.0,15122,14,12,2
37808,64,3187.0,15124,22,13,9
38005,985,3187.0,15125,16,17,-1
38708,985,3187.0,15126,16,11,5
38781,602,,15128,25,24,1
38782,256,,15129,25,26,-1
38783,729,,15130,25,25,0
38784,729,,15131,25,23,2
38785,261,,15132,25,25,0
38786,255,,15133,25,24,1
38787,255,,15134,25,25,0
39066,258,,15135,25,21,4
38788,571,,15136,25,25,0
38789,256,,15137,25,25,0
38790,258,,15138,25,15,10
38791,259,,15139,25,18,7
38792,259,,15140,25,24,1
38794,260,,15142,25,23,2
37590,261,3283.0,15143,25,25,0
38795,602,3285.0,15144,25,24,1
38796,602,3285.0,15145,25,20,5
38245,260,3363.0,15146,25,27,-2
38797,260,3364.0,15147,25,25,0
38799,96,3530.0,15149,20,17,3
38800,96,3530.0,15150,20,19,1
38801,267,3739.0,15151,25,25,0
38802,267,3739.0,15152,25,25,0
38803,17,3852.0,15153,25,28,-3
38804,267,3959.0,15154,25,24,1
38805,267,3959.0,15155,25,24,1
38806,256,4050.0,15156,25,26,-1
38807,571,4167.0,15157,25,26,-1
38808,571,4167.0,15158,25,26,-1
38810,17,4310.0,15159,15,14,1
38256,729,4338.0,15160,15,13,2
37116,96,3218.0,15163,18,16,2
37117,1043,3218.0,15164,18,19,-1
37271,654,3218.0,15165,19,19,0
38997,129,3218.0,15166,18,19,-1
38998,509,3218.0,15167,18,19,-1
38999,38,,15168,25,23,2
39000,437,,15169,25,11,14
39001,881,,15170,25,25,0
39002,68,,15171,25,25,0
39003,223,,15172,25,24,1
37139,684,3077.0,15177,25,29,-4
37140,278,3077.0,15178,25,25,0
37141,278,3077.0,15179,25,26,-1
37142,274,3077.0,15180,25,26,-1
37143,274,3077.0,15181,25,24,1
37574,995,3077.0,15182,25,26,-1
38339,995,3077.0,15183,25,25,0
37576,431,3141.0,15184,20,14,6
38341,431,3141.0,15185,20,20,0
39009,431,3141.0,15186,20,11,9
37577,995,3142.0,15188,20,17,3
37578,273,3143.0,15189,20,20,0
38342,273,3212.0,15190,20,22,-2
39053,273,3212.0,15191,20,18,2
37935,995,3213.0,15192,20,19,1
37237,893,2351.0,15208,30,23,7
38154,893,2351.0,15209,30,11,19
37296,285,2372.0,15210,15,11,4
38852,285,2372.0,15211,15,19,-4
37238,832,2373.0,15212,15,12,3
37067,586,2443.0,15215,10,11,-1
38155,284,2443.0,15216,10,11,-1
37600,1042,2369.0,15217,18,13,5
37601,289,2369.0,15218,18,14,4
37602,864,2369.0,15219,18,18,0
37603,864,2369.0,15220,18,19,-1
37604,289,2369.0,15221,18,17,1
37990,289,2369.0,15222,18,18,0
37249,288,2371.0,15223,18,16,2
37251,288,2371.0,15224,18,18,0
37354,986,2371.0,15225,18,13,5
38910,986,2371.0,15226,18,11,7
38911,288,2399.0,15227,18,20,-2
37282,1043,3059.0,15232,20,16,4
37189,295,2957.0,15234,32,31,1
37190,295,2957.0,15235,32,29,3
37191,294,2957.0,15236,32,32,0
37214,297,2957.0,15237,32,33,-1
37215,298,2957.0,15238,32,24,8
37558,294,2957.0,15239,32,31,1
37559,298,2957.0,15240,32,12,20
37796,297,2957.0,15241,32,33,-1
37120,733,3012.0,15242,25,14,11
37368,733,3012.0,15243,25,20,5
37560,299,3013.0,15244,25,25,0
37561,299,3013.0,15245,25,26,-1
37192,302,3014.0,15246,32,32,0
37193,297,3014.0,15247,32,32,0
37194,302,3014.0,15248,32,32,0
37195,300,3014.0,15249,32,14,18
37227,297,3014.0,15250,32,32,0
38008,611,3014.0,15251,32,14,18
38746,300,3014.0,15252,32,13,19
37797,299,3150.0,15253,25,25,0
38010,947,3222.0,15254,29,29,0
38748,295,3297.0,15256,25,24,1
38749,733,3298.0,15257,25,24,1
37798,302,3300.0,15258,25,22,3
38011,610,3301.0,15259,25,25,0
38185,300,3375.0,15260,25,17,8
37205,304,3967.0,15265,20,19,1
38012,304,3967.0,15266,20,18,2
37196,309,2959.0,15272,27,25,2
37197,309,2959.0,15273,27,27,0
37198,307,2959.0,15274,27,30,-3
37199,948,2959.0,15275,27,23,4
37554,948,2959.0,15276,27,16,11
37555,307,2959.0,15277,27,28,-1
37941,311,2959.0,15278,27,18,9
37942,308,2959.0,15279,27,22,5
38677,308,2959.0,15280,27,27,0
37121,310,3019.0,15281,27,27,0
37122,310,3019.0,15282,27,28,-1
37665,310,3019.0,15283,27,26,1
37220,309,3021.0,15284,27,27,0
37369,948,3022.0,15285,28,28,0
38678,736,3023.0,15286,27,27,0
38679,736,3023.0,15287,27,27,0
37123,313,3089.0,15288,27,30,-3
37124,313,3089.0,15289,27,29,-2
38080,868,3089.0,15290,27,27,0
38142,868,3089.0,15291,27,28,-1
37125,613,3090.0,15292,24,26,-2
37126,613,3090.0,15293,24,24,0
38680,613,3156.0,15294,25,22,3
37535,307,3158.0,15295,27,26,1
37905,307,3158.0,15296,27,27,0
37308,906,3159.0,15297,25,26,-1
37298,311,3160.0,15298,27,23,4
37370,311,3160.0,15299,27,27,0
37793,308,3308.0,15303,20,16,4
38681,736,3309.0,15304,20,21,-1
37943,868,3460.0,15306,20,15,5
37423,319,3335.0,15308,20,18,2
37420,614,3404.0,15311,18,19,-1
37081,318,3483.0,15312,20,15,5
37302,319,3665.0,15320,13,11,2
38363,319,3665.0,15321,13,14,-1
37416,322,3666.0,15322,18,18,0
38325,321,3768.0,15323,23,26,-3
38047,949,3015.0,15329,15,12,3
38987,335,3016.0,15331,20,17,3
38049,580,3017.0,15332,28,29,-1
38051,346,3017.0,15333,28,27,1
38344,346,3017.0,15334,28,26,2
37272,873,3018.0,15335,26,26,0
37456,873,3018.0,15336,26,26,0
38988,951,3018.0,15337,26,17,9
37458,333,3087.0,15338,28,27,1
37459,1046,3087.0,15339,28,22,6
38989,951,3087.0,15340,28,28,0
37568,334,3153.0,15341,28,18,10
38346,343,3153.0,15343,28,13,15
37454,350,3155.0,15344,25,21,4
37455,350,3155.0,15345,29,29,0
37842,114,3155.0,15346,25,18,7
38347,114,3155.0,15347,25,15,10
38350,343,3229.0,15350,28,28,0
37136,349,3302.0,15351,28,28,0
37180,349,3302.0,15352,28,28,0
37223,739,3302.0,15353,26,26,0
37258,739,3302.0,15354,26,26,0
37260,950,3302.0,15355,28,28,0
37261,950,3302.0,15356,28,28,0
37570,1046,3302.0,15357,28,28,0
37571,1046,3302.0,15358,28,28,0
37572,1047,3302.0,15359,28,28,0
37648,345,3302.0,15360,28,28,0
37687,345,3302.0,15361,28,28,0
39068,347,3302.0,15362,26,27,-1
39069,1047,3302.0,15363,28,28,0
39070,873,3302.0,15364,26,25,1
39071,159,3302.0,15365,26,26,0
39073,323,3302.0,15366,26,26,0
39074,951,3302.0,15367,26,24,2
39075,1046,3302.0,15368,28,17,11
38990,873,3304.0,15369,20,17,3
37028,615,3378.0,15370,20,13,7
37844,270,3380.0,15372,20,21,-1
37845,343,3380.0,15373,20,17,3
38052,343,3380.0,15374,20,12,8
37460,951,3453.0,15375,20,14,6
37363,335,3549.0,15378,20,18,2
37030,344,3646.0,15379,20,16,4
38991,346,3755.0,15381,20,15,5
37106,354,2950.0,15391,15,13,2
37593,354,2950.0,15392,15,14,1
37409,363,3008.0,15393,15,17,-2
37833,363,3008.0,15394,15,14,1
37594,354,3009.0,15395,15,14,1
37834,618,3009.0,15396,15,21,-6
37595,356,3074.0,15397,16,17,-1
37835,356,3074.0,15398,15,19,-4
37058,167,3209.0,15401,15,15,0
37596,167,3209.0,15402,15,16,-1
37114,818,3211.0,15403,15,16,-1
37836,818,3211.0,15404,15,18,-3
37410,989,3286.0,15405,12,16,-4
37837,989,3286.0,15406,14,14,0
37987,163,3369.0,15408,13,12,1
37988,359,3439.0,15409,11,14,-3
38900,356,3538.0,15410,10,13,-3
37704,818,3540.0,15411,10,12,-2
38901,617,3541.0,15412,15,20,-5
37774,1049,3130.0,15417,10,11,-1
37090,365,3344.0,15422,25,26,-1
38763,365,3344.0,15423,25,21,4
37184,367,3407.0,15424,25,25,0
37580,368,3407.0,15425,25,25,0
38765,364,3487.0,15426,25,25,0
39021,364,3487.0,15427,25,25,0
38040,229,3578.0,15428,12,12,0
38766,368,3675.0,15429,25,25,0
38076,367,3773.0,15430,25,29,-4
37225,380,2990.0,15438,44,44,0
37670,380,2990.0,15439,44,43,1
37226,379,3055.0,15440,47,48,-1
38006,373,3055.0,15441,47,43,4
37132,399,3058.0,15443,65,67,-2
37666,399,3058.0,15444,66,64,2
37371,381,3126.0,15445,20,18,2
37372,385,3126.0,15446,20,20,0
37373,385,3126.0,15447,20,21,-1
37374,385,3126.0,15448,20,20,0
37375,381,3126.0,15449,20,20,0
37669,380,3126.0,15451,20,22,-2
37376,1004,3127.0,15452,44,44,0
37377,619,3196.0,15460,44,44,0
38007,621,3196.0,15461,44,44,0
37149,387,3332.0,15478,38,20,18
37516,377,3332.0,15479,38,38,0
37886,387,3332.0,15480,38,38,0
38924,377,3332.0,15481,21,21,0
38925,374,3332.0,15482,60,57,3
37150,382,3333.0,15483,57,52,5
37887,389,3333.0,15484,57,55,2
37514,876,3401.0,15500,28,27,1
38927,379,3401.0,15501,28,27,1
37204,374,3479.0,15512,44,44,0
37279,383,3479.0,15513,44,44,0
37890,385,3479.0,15514,60,58,2
37151,409,3480.0,15515,28,28,0
38055,372,3480.0,15516,28,25,3
38929,910,3480.0,15517,59,57,2
37262,422,3569.0,15538,57,57,0
37177,399,3571.0,15548,88,88,0
37178,380,3662.0,15558,88,88,0
37063,422,3764.0,15560,85,83,2
37303,603,3874.0,15565,24,23,1
38065,603,3874.0,15566,20,20,0
38078,603,3874.0,15567,20,16,4
37304,1098,3980.0,15568,20,18,2
37893,387,3981.0,15569,20,16,4
37305,421,3982.0,15570,30,22,8
37309,419,3982.0,15571,30,28,2
37523,420,4065.0,15572,30,25,5
37306,390,4125.0,15573,40,36,4
38317,634,4127.0,15574,25,23,2
38318,619,4127.0,15575,25,18,7
37310,389,4175.0,15576,25,24,1
37537,425,4179.0,15577,25,24,1
38066,425,4217.0,15578,25,23,2
37632,426,4287.0,15583,30,23,7
37633,420,4287.0,15584,30,28,2
37721,422,4315.0,15585,20,18,2
39090,422,4315.0,15586,20,12,8
37422,420,4317.0,15587,14,14,0
37635,420,2768.0,15588,15,15,0
37636,420,2827.0,15589,14,14,0
37637,429,2893.0,15590,14,14,0
37638,420,2894.0,15591,14,14,0
37758,429,2954.0,15592,15,15,0
37200,275,2683.0,15596,25,26,-1
37201,275,2683.0,15597,25,27,-2
37202,912,2683.0,15598,25,32,-7
37203,878,2683.0,15599,25,26,-1
37222,912,2683.0,15600,25,28,-3
37269,878,2683.0,15601,25,29,-4
37579,430,2683.0,15602,25,25,0
37664,430,2683.0,15603,25,24,1
38082,430,2683.0,15604,25,23,2
37461,1059,2685.0,15605,25,24,1
37462,1059,2685.0,15606,25,24,1
37463,959,2685.0,15607,25,25,0
37464,435,2685.0,15608,25,25,0
37465,879,2685.0,15609,25,25,0
37466,879,2685.0,15610,25,24,1
37467,1057,2685.0,15611,25,27,-2
37468,879,2685.0,15612,25,21,4
37469,435,2685.0,15613,25,25,0
37470,436,2685.0,15614,25,25,0
37471,1057,2685.0,15615,25,25,0
37472,440,2685.0,15616,25,25,0
37473,443,2685.0,15617,25,25,0
37474,443,2685.0,15618,25,25,0
37475,443,2685.0,15619,25,25,0
37959,754,2685.0,15620,25,25,0
38258,754,2685.0,15621,25,26,-1
38985,436,2685.0,15622,25,25,0
37477,880,2758.0,15623,20,20,0
37478,880,2758.0,15624,20,19,1
37479,437,2760.0,15625,20,19,1
37480,442,2817.0,15626,20,19,1
37481,442,2817.0,15627,20,20,0
37482,913,2875.0,15628,20,20,0
38261,913,2877.0,15629,20,19,1
38855,443,2935.0,15630,20,17,3
38263,441,2937.0,15631,20,20,0
38856,436,,15632,20,21,-1
38264,441,2939.0,15633,20,20,0
37816,450,2984.0,15634,20,20,0
37817,450,2984.0,15635,20,20,0
37483,1060,2987.0,15636,20,19,1
37484,440,2987.0,15637,20,20,0
37485,449,2989.0,15638,20,20,0
37486,1060,2989.0,15639,20,20,0
38857,449,3049.0,15640,20,20,0
38858,879,3050.0,15641,20,17,3
38859,438,3113.0,15642,20,20,0
38860,438,3113.0,15643,20,20,0
38266,438,3114.0,15644,20,21,-1
38862,435,3259.0,15646,15,15,0
38827,457,2754.0,15649,26,27,-1
38828,457,2754.0,15650,26,26,0
37892,459,2755.0,15651,20,20,0
39058,459,2755.0,15652,20,20,0
37217,755,2756.0,15653,26,24,2
38829,458,2812.0,15654,26,24,2
38014,455,2871.0,15655,26,22,4
38015,454,2871.0,15656,26,24,2
38016,457,2871.0,15657,26,26,0
38017,755,2871.0,15658,26,21,5
38018,455,2871.0,15659,26,15,11
38019,1061,2871.0,15660,26,23,3
38020,1061,2872.0,15661,24,24,0
38021,458,2872.0,15662,24,23,1
38022,457,2872.0,15663,24,24,0
38023,455,2872.0,15664,24,24,0
38024,755,2872.0,15665,24,23,1
38025,755,2872.0,15666,24,13,11
39013,458,2873.0,15667,10,11,-1
38717,462,,15672,25,25,0
38720,465,,15675,25,23,2
38727,1063,,15681,25,18,7
38728,465,,15682,25,22,3
38729,1063,,15683,25,23,2
38730,464,,15684,25,12,13
38731,465,,15685,25,12,13
38732,464,,15686,25,16,9
38733,284,,15687,25,13,12
38734,223,,15688,25,13,12
37035,883,2745.0,15696,30,12,18
37036,472,2745.0,15697,30,30,0
37680,883,2745.0,15698,30,28,2
37608,470,2746.0,15700,30,29,1
37609,470,2746.0,15701,30,22,8
38191,638,2746.0,15702,30,24,6
38192,474,2807.0,15703,21,18,3
37619,474,2808.0,15704,20,20,0
38816,1100,2809.0,15705,25,15,10
37620,638,2811.0,15706,20,19,1
37623,476,2811.0,15707,20,17,3
37610,473,2868.0,15712,17,17,0
37611,960,2868.0,15713,17,17,0
37626,638,2869.0,15714,24,23,1
37681,478,2870.0,15715,20,19,1
37612,472,2928.0,15716,23,22,1
38817,474,2928.0,15717,20,20,0
37627,960,2930.0,15718,26,27,-1
38818,638,2974.0,15719,20,19,1
38819,469,2977.0,15720,20,20,0
37613,1065,3040.0,15721,25,24,1
38195,1065,3040.0,15722,22,21,1
37629,1065,3041.0,15723,26,25,1
37084,1065,3042.0,15724,20,18,2
37146,480,3042.0,15725,20,20,0
38820,478,,15726,20,17,3
38822,960,,15728,22,22,0
37618,469,3175.0,15734,15,14,1
37974,478,3251.0,15735,16,16,0
38824,476,3253.0,15736,15,14,1
38825,480,3254.0,15737,15,15,0
37975,478,3325.0,15738,30,15,15
37531,757,3475.0,15741,15,14,1
37082,483,3564.0,15742,20,13,7
37533,482,3758.0,15745,15,11,4
37228,1101,3759.0,15746,20,13,7
37083,485,3868.0,15747,20,11,9
37873,482,4060.0,15752,15,11,4
38242,881,2630.0,15754,15,13,2
37757,221,2633.0,15755,15,12,3
38149,1066,,15759,20,20,0
38332,1102,2575.0,15764,20,13,7
38333,691,2672.0,15765,20,14,6
39116,691,2672.0,15766,20,17,3
38334,1009,2732.0,15767,20,13,7
38863,642,2703.0,15768,25,19,6
38864,642,2703.0,15769,25,25,0
37487,272,2704.0,15770,25,25,0
37488,272,2704.0,15771,25,25,0
37963,272,2704.0,15772,25,25,0
37964,493,2704.0,15773,25,25,0
38865,1067,2704.0,15774,25,21,4
38866,1067,2704.0,15775,25,25,0
38867,494,2704.0,15776,25,24,1
37489,496,2778.0,15777,25,25,0
37490,496,2778.0,15778,25,25,0
37491,496,2778.0,15779,25,24,1
37492,497,2778.0,15780,25,23,2
37493,497,2778.0,15781,25,24,1
37660,963,2779.0,15782,25,25,0
38273,963,2779.0,15783,25,29,-4
37661,499,2779.0,15784,20,20,0
37895,499,2779.0,15785,20,20,0
38271,492,2779.0,15786,20,19,1
38272,492,2779.0,15787,20,20,0
39128,499,2779.0,15788,20,20,0
38868,501,2838.0,15789,25,24,1
37494,500,2840.0,15790,25,25,0
38013,501,2901.0,15791,25,24,1
39026,886,2960.0,15792,20,20,0
38274,489,2961.0,15793,35,18,17
38275,997,3024.0,15794,25,25,0
37857,915,3029.0,15795,20,20,0
37233,916,3092.0,15796,25,25,0
37967,962,3094.0,15797,25,25,0
38870,962,3094.0,15798,25,27,-2
38084,645,3163.0,15799,20,20,0
39019,645,3163.0,15800,20,19,1
38278,643,3236.0,15801,25,12,13
38869,643,3236.0,15802,25,24,1
37567,505,3237.0,15803,25,25,0
38871,493,3311.0,15804,25,25,0
38872,493,3311.0,15805,25,25,0
38873,503,,15806,25,25,0
38874,494,3385.0,15807,25,24,1
38875,494,3385.0,15808,25,23,2
38876,642,3461.0,15809,25,25,0
38921,1067,,15810,25,18,7
37040,648,2497.0,15814,30,30,0
37131,1068,2497.0,15815,30,30,0
37357,251,2497.0,15816,25,24,1
37759,509,2497.0,15817,30,25,5
38878,648,2497.0,15818,30,19,11
38847,1068,2542.0,15819,25,12,13
38848,764,2543.0,15820,25,25,0
38849,764,2544.0,15821,25,22,3
38850,1068,2590.0,15822,25,18,7
37147,507,2591.0,15823,30,29,1
37547,507,2591.0,15824,30,30,0
38967,507,2647.0,15825,30,30,0
37940,251,2649.0,15826,27,26,1
37548,251,2650.0,15827,27,27,0
37207,251,2651.0,15828,27,27,0
38851,1068,2847.0,15830,25,15,10
37206,511,2581.0,15838,15,12,3
37522,519,2675.0,15840,20,21,-1
38904,706,,15841,15,15,0
38905,161,2679.0,15842,16,15,1
38907,888,2801.0,15845,20,23,-3
37107,784,2862.0,15846,15,14,1
37706,520,2863.0,15847,15,12,3
37728,534,2549.0,15851,18,18,0
37729,534,2549.0,15852,18,18,0
37730,811,2549.0,15853,18,18,0
37731,811,2549.0,15854,18,17,1
37733,536,2549.0,15856,18,16,2
37748,655,2549.0,15857,18,19,-1
37749,655,2549.0,15858,18,17,1
37754,523,2549.0,15859,18,18,0
38231,523,2549.0,15860,18,18,0
38914,529,2549.0,15861,18,12,6
37862,767,2551.0,15862,18,18,0
37863,767,2551.0,15863,18,18,0
37864,530,2551.0,15864,18,16,2
37866,964,2551.0,15866,18,18,0
37867,964,2551.0,15867,18,18,0
37868,524,2551.0,15868,18,18,0
37869,524,2551.0,15869,18,19,-1
38915,524,2551.0,15870,18,18,0
37639,1069,2593.0,15871,18,18,0
37734,1069,2593.0,15872,18,18,0
37735,535,2593.0,15873,18,17,1
37736,531,2593.0,15874,18,17,1
37737,531,2593.0,15875,18,15,3
37750,964,2593.0,15876,18,18,0
37751,964,2593.0,15877,18,17,1
37752,538,2593.0,15878,18,16,2
37755,538,2593.0,15879,18,19,-1
37756,527,2593.0,15880,18,18,0
38916,527,2593.0,15881,18,12,6
37761,524,2594.0,15882,15,16,-1
38917,527,2595.0,15883,15,13,2
37167,654,2654.0,15884,15,14,1
37991,654,2654.0,15885,15,14,1
38919,1069,2718.0,15887,15,13,2
38983,965,2635.0,15892,20,17,3
37717,541,2638.0,15893,20,15,5
38074,483,2691.0,15894,20,13,7
37278,151,2692.0,15895,20,15,5
38767,546,2496.0,15904,18,17,1
37111,660,2537.0,15905,16,16,0
38768,660,2537.0,15906,16,16,0
38769,1103,2589.0,15907,18,16,2
38770,545,2639.0,15908,16,16,0
38174,546,2641.0,15909,18,17,1
37234,549,2643.0,15910,15,13,2
38771,548,2697.0,15911,18,18,0
38772,548,2697.0,15912,18,18,0
39055,548,2697.0,15913,18,18,0
38773,549,,15914,15,13,2
38079,552,2666.0,15924,20,15,5
37812,12,2506.0,15932,18,17,1
37412,664,2552.0,15933,24,16,8
38419,12,2554.0,15934,12,12,0
37102,561,2391.0,15935,24,23,1
37498,666,2426.0,15936,17,15,2
37161,17,2353.0,15955,15,14,1
